NO ./textures/north.xpm
SO ./textures/south.xpm
WE ./textures/west.xpm
EA ./textures/east.xpm

F 220,100,0
C 225,30,0

1111111111111111111111111
1000000001110000000000001
1011000001 100000000000001
10010000011100000000000011111111
111111111011000001110000000000001
100010010011000001110111111111111
11111111111111011100000000001
11110111111111011101010010001
11001000110101011100000010001
10000000000000001100000010001
10000000000000000001010010001
110000011101010111011110N0111
11110111 1110101 101111010001
11111111 1111111 111111111111
11111111111111111111111111111