NO ./textures/north.xpm
SO ./textures/south.xpm
WE ./textures/west.xpm
EA ./textures/east.xpm

C 200,200,200   
F 50,50,50

11111111111111111111
10000000000000000001
10000000000000000001
10000000000000000001
100000000000000000011111
100000000000000000N00001
100000000000000000011111
10000000000000000001
10000000000000000001
10000000000000000001
11111111111111111111
