NO ./textures/north.xpm
SO ./textures/south.xpm
WE ./textures/west.xpm
EA ./textures/east.xpm

F 101,67,33
C 135,206,235

111111111111111111111
100000000010000000001
101111111010111111101
101000001010100000101
101011101010101110101
101010001010101000101
101011111010101111101
101000000010000000001
101111111111111111101
1000000000N0000000001
111111111111111111111
