NO ./textures/north.xpm
SO ./textures/south.xpm
WE ./textures/west.xpm
EA ./textures/east.xpm

F 300,0,0
C 10,10
F 2,0,0

111111
10S001
100001
111111
